222222222222222222222222222222222222222222222222222222222222222222222222222222222222222222222222222222222222222222222222222222222222222222222222222222222222222222222222222222222222222222222222222222222222222222222222222222222222222222222222222222222222222222222222222222222
222222222222222222222222222222222222222222222222222222222222222222222222222222222222222222222222222222222222222222222222222222222222222222222222222222222222222222222222222222222222222222222222222222222222222222222222222222222222222222222222222222222222222222222222222222222
222222222222222222222222222222222222222222222222222222222222222222222222222222222222222222222222222222222222222222222222222222222222222222222222222222222222222222222222222222222222222222222222222222222222222222222222222222222222222222222222222222222222222222222222222222222
222222222222222222222222222222222222222222222222222222222222222222222222222222222222222222222222222222222222222222222222222222222222222222222222222222222222222222222222222222222222222222222222222222222222222222222222222222222222222222222222222222222222222222222222222222222
222222222222222222222222222222222222222222222222222222222222222222222222222222222222222222222222222222222222222222222222222222222222222222222222222222222222222222222222222222222222222222222222222222222222222222222222222222222222222222222222222222222222222222222222222222222
222222222222222222222222222222222222222222222222222222222222222222222222222222222222222222222222222222222222222222222222222222222222222222222222222222222222222222222222222222222222222222222222222222222222222222222222222222222222222222222222222222222222222222222222222222222
222222222222222222222222222222222222222222222222222222222222222222222222222222222222222222222222222222222222222222222222222222222222222222222222222222222222222222222222222222222222222222222222222222222222222222222222222222222222222222222222222222222222222222222222222222222
222222222222222222222222222225555552222222222222222222222222222222222222222222222222222222222222222222222222222222222222222222222222222222222222222222222222222222222222222222222222222222222222222222222222222222222222225555552222222222222222222222222222222222222222222222222
222222255555522222222222222220000002222222222222222222222222222222222222222222222222222222222222222222222222222222222222222222222222222222222222222222222222222222222222222222222222222222222222222255555522222222222222220000002222222222222222222222222222222222222222222222222
222222200000022222222222222220000002222222222222222222222222222222222222222222222222222555555555522222222222222222222222222222222222222222222222222222222222222222222222222222222222222222222222222200000022222222222222220000002222222222222222222222222222222222222222222222222
222222200000022222222222255550000002222222222222222222222222222222222222222222222222222000000000022222222222222222222222222222222222222222222222222222222222222222222222222222222222222222222222222200000022222222222255550000002222222222222222222222222222222222222222222222222
222222200000055555522222200000000005555555555555555555555555555555555552222222222222222000000000022222222222222222222222222222222222222222222222222222222222222222222222222222225555555555555222222200000055555522222200000000005555555555555555555555555555555555552222222222222
555555500000000000022222200000000000000000000000000000000000000000000000222222222222222000000000022222222222222222222222222222222222222222222222222222222222222222225555555555550000000000000555555500000000000022222200000000000000000000000000000000000000000000000222222222222
777777700000000000055555500000000000000000000000000000000000055555550000222222225555555000000000022222222222222222222222222222222222222222222222222222222222222222220000000000000000000000000000000000000000000055555500000000000000000000000000000000000055555550000222222225555
000000000000000000000000000000000000000000000000000000000000000000000000222222220000000000000000055555555522222222222222222225555555555555555555555555555555555555550000000000000000000000000000000000000000000000000000000000000000000000000000000000000000000000000222222220000
000000000000000000000000000000000000000000000000000000000000000000000000222222220000000000000000055555555522222222222222222220000000000000000000000000000000000000000000000000000000000000000000000000000000000000000000000000000000000000000000000000000000000000000222222220000
000000000000000000000000000003333330000000033333333300000000000000000000222222220000000000000000000000000022222222222222222220000000000000000000000000000000000000000000000000000000000000000000000000000000000000000000000000000000000033333333300000000000000000000222222220000
000000033333300000000000000001111110000000044444444400000000000000000000555555550000000000000000000000000022222222222222222220000000000000000000000000000000000000000000000000000000000000000000000033333300000000000000001111110000000044444444400000000000000000000555555550000
000000011111100000000000033331111110000000000000000000000555555550000000000000000000000000000000000000000022222222225555555550000000000000000000000000000000000000000000000000003333333333333000000011111100000000000033331111110000000000000000000000000000000000000000000000000
777777711111100000000000011111111110000000000000000000000000000000000000000000000000000003333333300000000055555555550000000000000000000000000000000033333333330000000000033333331111111111111000000011111100000000000011111111110000000000000000000000000000000000000000000000000
333333311111133333000000011111111113333333333333333300000000000000000000000000000000000001111111100000000000000000000000000000000000000000000000000011111111110000000000011111111111111111111333333311111133333000000011111111113333333333333333300000000000000000000000000000000
111111111111111111000000011111111111111111111111111133333333333333333000000000000000000001111111100000000000000000000000000000333333333000000000000044444444440000003333311111111111111111111111111111111111111000000011111111111111111111111111133333333333333333000000000000000
111111111111111111000000011111111111111111111111111111111111111111111000000000003333333331111111100000000000000000000000000000111111111000000000000000000000000000001111111111111111111111111111111111111111111000000011111111111111111111111111111111111111111111000000000003333
111111111111111111333333311111111111111111111111111111111111111111111000000000001111111111111111133333333300000000003333333333111111111333333333333300000000000000001111111111111111111111111111111111111111111333333311111111111111111111111111111111111111111111000000000001111
111111111111111111111111111111111111111111111111111111111111111111111000000000001111111111111111111111111100000000001111111111111111111111111111111133333333333333331111111111111111111111111111111111111111111111111111111111111111111111111111111111111111111111000000000001111
111111111111111111111111111111111111111111111111111111111111111111111333333333331111111111111111111111111100000000001111111111111111111111111111111111111111111111111111111111111111111111111111111111111111111111111111111111111111111111111111111111111111111111333333333331111
111111111111111111111111111111111111111111111111111111111111111111111111111111111111111111111111111111111100000000001111111111111111111111111111111111111111111111111111111111111111111111111111111111111111111111111111111111111111111111111111111111111111111111111111111111111
111111111111111111111111111111111111111111111111111111111111111111111111111111111111111111111111111111111133333333331111111111111111111111111111111111111111111111111111111111111111111111111111111111111111111111111111111111111111111111111111111111111111111111111111111111111
111111111111111111111111111111111111111111111111111111111111111111111111111111111111111111111111111111111111111111111111111111111111111111111111111111111111111111111111111111111111111111111111111111111111111111111111111111111111111111111111111111111111111111111111111111111
111111111111111111111111111111111111111111111111111111111111111111111111111111111111111111111111111111111111111111111111111111111111111111111111111111111111111111111111111111111111111111111111111111111111111111111111111111111111111111111111111111111111111111111111111111111
111111111111111111111111111111111111111111111111111111111111111111111111111111111111111111111111111111111111111111111111111111111111111111111111111111111111111111111111111111111111111111111111111111111111111111111111111111111111111111111111111111111111111111111111111111111
111111111111111111111111111111111111111111111111111111111111111111111111111111111111111111111111111111111111111111111111111111111111111111111111111111111111111111111111111111111111111111111111111111111111111111111111111111111111111111111111111111111111111111111111111111111
111111111111111111111111111111111111111111111111111111111111111111111111111111111111111111111111111111111111111111111111111111111111111111111111111111111111111111111111111111111111111111111111111111111111111111111111111111111111111111111111111111111111111111111111111111111
111111111111111111111111111111111111111111111111111111111111111111111111111111111111111111111111111111111111111111111111111111111111111111111111111111111111111111111111111111111111111111111111111111111111111111111111111111111111111111111111111111111111111111111111111111111



